10
10
1
9
3
0
2
1001010010
1100110010
1011011010
0001001000
0001100000
1001000110
0101100000
1100101110
0100000001
0001110011