6
5
1
1
1
3
0
11111
10101
10001							 
10101							
10001							
11111						 