7
8
5
7
5
0
2
11111111
10001111
10101111
10101111
10101111
00100110
11111111