6
5
3
1
1
3
1
11111
10101
11001
10101
10001
11111                            