14
13
0
1
3
8
1
1011111111111
1011110000011
1011110111011
1000010101011
1111010001011
1111011111011
1111001011011
1111111011011
1111111011011
1111111011011
1111111000011
1111111111111
1111111111111
1111111111111
