27
17
26
1
0
0
2
01111111111111111 
00000000111111111 
11111110111111111 
10000000111111111 
10111111111111111  
10111111111111111  
10111000000000000
10111011111111110 
10111000111111110
10111110110000110
10000000110110110
11111111110110110
11111111110110110
10000000010110000
10111111010111111
10100001010111111
10101101010111111
10101100010111111
10101111110111111
10100000000111111
10111111111111111
10000111111111111
11110111111111111
11100111111111111
11001111111111111
10011111111111111
10111111111111111
